"aa" = (/turf/template_noop,/area/template_noop)
"ab" = (/turf/closed/wall/mineral/titanium,/area/shuttle/abandoned/cargo)
"ac" = (/turf/closed/wall/mineral/titanium,/area/shuttle/abandoned/medbay)
"ad" = (/turf/open/floor/plasteel,/area/shuttle/abandoned/cargo)
"ae" = (/turf/open/floor/plating,/area/shuttle/abandoned/cargo)
"af" = (/obj/machinery/door/airlock/external,/turf/closed/wall/mineral/titanium,/area/shuttle/abandoned/cargo)
"ag" = (/obj/machinery/atmospherics/components/unary/thermomachine/freezer,/obj/effect/turf_decal/delivery,/turf/open/floor/plasteel,/area/shuttle/abandoned/medbay)
"ah" = (/obj/machinery/atmospherics/components/unary/portables_connector,/obj/machinery/portable_atmospherics/canister/oxygen,/obj/machinery/power/apc/auto_name/north,/obj/structure/cable,/turf/open/floor/plasteel/white,/area/shuttle/abandoned/medbay)
"ai" = (/obj/machinery/atmospherics/components/unary/cryo_cell,/turf/open/floor/plasteel/white,/area/shuttle/abandoned/medbay)
"aj" = (/obj/structure/fans/tiny,/turf/open/floor/plasteel,/area/shuttle/abandoned/cargo)
"ak" = (/obj/structure/bed/roller,/turf/open/floor/plasteel,/area/shuttle/abandoned/cargo)
"al" = (/turf/closed/wall/mineral/titanium,/area/shuttle/abandoned/bridge)
"am" = (/obj/machinery/smartfridge/chemistry,/turf/open/floor/plasteel/white,/area/shuttle/abandoned/medbay)
"an" = (/turf/open/floor/plasteel/white,/area/shuttle/abandoned/medbay)
"ao" = (/obj/machinery/atmospherics/pipe/simple/cyan/visible{icon_state = "pipe11-2"; dir = 5},/obj/structure/cable,/turf/open/floor/plasteel/white,/area/shuttle/abandoned/medbay)
"ap" = (/obj/machinery/atmospherics/pipe/manifold/cyan/visible,/obj/item/wrench/medical,/obj/structure/cable,/turf/open/floor/plasteel/white,/area/shuttle/abandoned/medbay)
"aq" = (/obj/machinery/atmospherics/pipe/simple/cyan/visible{dir = 9},/turf/open/floor/plasteel/white,/area/shuttle/abandoned/medbay)
"ar" = (/obj/machinery/atmospherics/pipe/simple/scrubbers/hidden/layer3{icon_state = "pipe11-3"; dir = 6},/obj/machinery/atmospherics/pipe/simple/supply{icon_state = "pipe11-2"; dir = 6},/obj/structure/cable,/turf/open/floor/plasteel,/area/shuttle/abandoned/cargo)
"as" = (/obj/machinery/atmospherics/pipe/simple/scrubbers/hidden/layer3{icon_state = "pipe11-3"; dir = 4},/obj/machinery/atmospherics/pipe/simple/supply{icon_state = "pipe11-2"; dir = 8},/obj/structure/cable,/turf/open/floor/plasteel,/area/shuttle/abandoned/cargo)
"at" = (/obj/machinery/atmospherics/pipe/simple/supply{icon_state = "pipe11-2"; dir = 10},/obj/machinery/atmospherics/pipe/simple/scrubbers/hidden/layer3{icon_state = "pipe11-3"; dir = 8},/obj/structure/cable,/turf/open/floor/plasteel,/area/shuttle/abandoned/cargo)
"au" = (/obj/machinery/atmospherics/components/unary/vent_scrubber/on/layer3{icon_state = "scrub_map_on-3"; dir = 8},/obj/structure/cable,/turf/open/floor/plasteel,/area/shuttle/abandoned/cargo)
"av" = (/obj/structure/cable,/turf/open/floor/plasteel,/area/shuttle/abandoned/cargo)
"aw" = (/obj/structure/shuttle/engine/heater{dir = 4},/turf/open/floor/plating,/area/shuttle/abandoned/cargo)
"ax" = (/obj/structure/shuttle/engine/propulsion{dir = 4},/turf/closed/wall/mineral/titanium,/area/shuttle/abandoned/cargo)
"ay" = (/obj/effect/spawner/structure/window/shuttle,/obj/structure/grille,/turf/open/floor/plating,/area/shuttle/abandoned/bridge)
"az" = (/turf/open/floor/carpet/royalblue,/area/shuttle/abandoned/bridge)
"aA" = (/obj/structure/table,/obj/item/storage/backpack/duffelbag/med/surgery,/obj/item/storage/firstaid/fire,/obj/item/storage/firstaid/brute,/turf/open/floor/plasteel/white,/area/shuttle/abandoned/medbay)
"aB" = (/obj/item/reagent_containers/glass/beaker/cryoxadone,/obj/structure/table,/obj/item/taperecorder,/obj/structure/cable,/turf/open/floor/plasteel/white,/area/shuttle/abandoned/medbay)
"aC" = (/obj/structure/table,/obj/item/paper_bin,/obj/item/pen,/turf/open/floor/plasteel/white,/area/shuttle/abandoned/medbay)
"aD" = (/obj/machinery/atmospherics/pipe/simple/scrubbers/hidden/layer3,/obj/machinery/atmospherics/pipe/simple/supply,/obj/structure/cable,/turf/open/floor/plasteel,/area/shuttle/abandoned/cargo)
"aE" = (/turf/closed/wall/mineral/titanium,/area/shuttle/abandoned/crew)
"aF" = (/obj/machinery/atmospherics/components/unary/vent_pump/on{dir = 1},/turf/open/floor/plasteel,/area/shuttle/abandoned/cargo)
"aG" = (/turf/open/floor/carpet,/area/shuttle/abandoned/bridge)
"aH" = (/obj/structure/table,/obj/item/storage/backpack/duffelbag/med,/obj/item/storage/firstaid/o2,/obj/item/storage/firstaid/medical,/obj/item/roller,/turf/open/floor/plasteel/white,/area/shuttle/abandoned/medbay)
"aI" = (/obj/machinery/atmospherics/components/unary/vent_scrubber/on/layer3{icon_state = "scrub_map_on-3"; dir = 4},/turf/open/floor/plasteel/white,/area/shuttle/abandoned/medbay)
"aJ" = (/obj/machinery/atmospherics/pipe/simple/scrubbers/hidden/layer3{icon_state = "pipe11-3"; dir = 10},/obj/machinery/atmospherics/pipe/simple/supply{icon_state = "pipe11-2"; dir = 6},/obj/structure/cable,/turf/open/floor/plasteel/white,/area/shuttle/abandoned/medbay)
"aK" = (/obj/machinery/atmospherics/components/unary/vent_pump/on{dir = 8},/turf/open/floor/plasteel/white,/area/shuttle/abandoned/medbay)
"aL" = (/obj/machinery/vending/snack,/turf/open/floor/carpet/orange,/area/shuttle/abandoned/crew)
"aM" = (/obj/structure/chair/comfy/beige{dir = 4},/turf/open/floor/carpet/orange,/area/shuttle/abandoned/crew)
"aN" = (/obj/machinery/power/apc/auto_name/north,/obj/structure/cable,/obj/structure/table,/turf/open/floor/carpet/orange,/area/shuttle/abandoned/crew)
"aO" = (/obj/structure/chair/comfy/beige{dir = 8},/turf/open/floor/carpet/orange,/area/shuttle/abandoned/crew)
"aP" = (/obj/machinery/computer/arcade,/turf/open/floor/carpet/orange,/area/shuttle/abandoned/crew)
"aQ" = (/obj/structure/table,/obj/item/storage/firstaid/toxin,/obj/item/storage/firstaid/regular,/turf/open/floor/plasteel/white,/area/shuttle/abandoned/medbay)
"aR" = (/obj/machinery/atmospherics/pipe/simple/scrubbers/hidden/layer3,/obj/machinery/atmospherics/pipe/simple/supply,/obj/structure/cable,/turf/open/floor/plasteel/white,/area/shuttle/abandoned/medbay)
"aS" = (/obj/machinery/computer/operating{dir = 1},/turf/open/floor/plasteel/white,/area/shuttle/abandoned/medbay)
"aT" = (/obj/structure/table/optable,/turf/open/floor/plasteel/white,/area/shuttle/abandoned/medbay)
"aU" = (/turf/open/floor/carpet/orange,/area/shuttle/abandoned/crew)
"aV" = (/obj/structure/cable,/obj/structure/table,/turf/open/floor/carpet/orange,/area/shuttle/abandoned/crew)
"aW" = (/obj/machinery/computer/med_data{dir = 4},/turf/open/floor/carpet/royalblue,/area/shuttle/abandoned/bridge)
"aX" = (/obj/machinery/atmospherics/components/unary/vent_scrubber/on/layer3,/turf/open/floor/carpet,/area/shuttle/abandoned/bridge)
"aY" = (/obj/machinery/power/apc/auto_name/east,/obj/structure/cable,/turf/open/floor/carpet/royalblue,/area/shuttle/abandoned/bridge)
"aZ" = (/obj/machinery/atmospherics/components/unary/vent_scrubber/on/layer3,/turf/open/floor/plasteel,/area/shuttle/abandoned/cargo)
"ba" = (/obj/machinery/atmospherics/components/unary/vent_scrubber/on/layer3,/turf/open/floor/carpet/orange,/area/shuttle/abandoned/crew)
"bb" = (/obj/structure/cable,/turf/open/floor/carpet/orange,/area/shuttle/abandoned/crew)
"bc" = (/obj/machinery/computer/camera_advanced/shuttle_docker/whiteship{icon_state = "computer"; dir = 4; x_offset = -7; y_offset = -8},/turf/open/floor/carpet/royalblue,/area/shuttle/abandoned/bridge)
"bd" = (/obj/machinery/door/poddoor{id = "northwhite"},/turf/open/floor/plating,/area/shuttle/abandoned/cargo)
"be" = (/obj/machinery/atmospherics/pipe/simple/scrubbers/hidden/layer3{icon_state = "pipe11-3"; dir = 4},/obj/machinery/atmospherics/pipe/simple/supply{icon_state = "pipe11-2"; dir = 8},/obj/structure/cable,/turf/open/floor/carpet/royalblue,/area/shuttle/abandoned/bridge)
"bf" = (/obj/machinery/atmospherics/pipe/manifold4w/scrubbers/hidden/layer3,/obj/machinery/atmospherics/pipe/manifold4w/supplymain,/obj/structure/cable,/turf/open/floor/plasteel,/area/shuttle/abandoned/cargo)
"bg" = (/obj/machinery/atmospherics/pipe/simple/scrubbers/hidden/layer3{icon_state = "pipe11-3"; dir = 4},/obj/machinery/atmospherics/pipe/simple/supply{icon_state = "pipe11-2"; dir = 4},/obj/structure/cable,/turf/open/floor/plasteel,/area/shuttle/abandoned/cargo)
"bh" = (/obj/machinery/atmospherics/pipe/manifold/scrubbers/hidden/layer3,/obj/machinery/atmospherics/pipe/manifold/supply{icon_state = "manifold-2"; dir = 1},/obj/structure/cable,/turf/open/floor/plasteel,/area/shuttle/abandoned/cargo)
"bi" = (/obj/structure/table,/obj/item/gps,/turf/open/floor/plasteel,/area/shuttle/abandoned/cargo)
"bj" = (/obj/machinery/atmospherics/pipe/simple/scrubbers/hidden/layer3{icon_state = "pipe11-3"; dir = 4},/obj/machinery/atmospherics/pipe/simple/supply{icon_state = "pipe11-2"; dir = 4},/obj/structure/cable,/turf/open/floor/carpet/orange,/area/shuttle/abandoned/crew)
"bk" = (/obj/machinery/atmospherics/pipe/simple/supply{icon_state = "pipe11-2"; dir = 10},/obj/machinery/atmospherics/pipe/simple/scrubbers/hidden/layer3{icon_state = "pipe11-3"; dir = 9},/obj/structure/cable,/turf/open/floor/carpet/orange,/area/shuttle/abandoned/crew)
"bl" = (/obj/machinery/power/apc/auto_name/east,/obj/structure/cable,/turf/open/floor/plasteel,/area/shuttle/abandoned/cargo)
"bm" = (/obj/machinery/computer/shuttle/white_ship{icon_state = "computer"; dir = 4},/turf/open/floor/carpet/royalblue,/area/shuttle/abandoned/bridge)
"bn" = (/obj/machinery/atmospherics/components/unary/vent_pump/on{dir = 1},/turf/open/floor/carpet,/area/shuttle/abandoned/bridge)
"bo" = (/turf/closed/wall/mineral/titanium,/area/shuttle/abandoned/engine)
"bp" = (/obj/machinery/power/apc/auto_name/north,/obj/structure/cable,/obj/structure/table,/obj/item/flashlight{pixel_x = -5; pixel_y = 5},/obj/item/flashlight,/turf/open/floor/plasteel,/area/shuttle/abandoned/cargo)
"bq" = (/obj/machinery/atmospherics/pipe/simple/scrubbers/hidden/layer3,/obj/machinery/atmospherics/pipe/simple/supply,/turf/open/floor/plasteel,/area/shuttle/abandoned/cargo)
"br" = (/obj/machinery/atmospherics/components/unary/vent_pump/on{dir = 1},/turf/open/floor/carpet/orange,/area/shuttle/abandoned/crew)
"bs" = (/obj/machinery/atmospherics/pipe/simple/supply{icon_state = "pipe11-2"; dir = 6},/turf/open/floor/noslip,/area/shuttle/abandoned/engine)
"bt" = (/obj/machinery/atmospherics/pipe/simple/scrubbers/hidden/layer3{icon_state = "pipe11-3"; dir = 6},/obj/machinery/atmospherics/pipe/simple/supply{icon_state = "pipe11-2"; dir = 8},/turf/open/floor/noslip,/area/shuttle/abandoned/engine)
"bu" = (/obj/machinery/atmospherics/pipe/manifold/scrubbers/hidden/layer3{icon_state = "manifold-3"; dir = 4},/obj/machinery/atmospherics/pipe/manifold/supply,/obj/structure/cable,/turf/open/floor/noslip,/area/shuttle/abandoned/engine)
"bv" = (/obj/machinery/atmospherics/components/unary/vent_pump/on{dir = 8},/turf/open/floor/noslip,/area/shuttle/abandoned/engine)
"bw" = (/turf/open/floor/noslip,/area/shuttle/abandoned/engine)
"bx" = (/obj/structure/table,/turf/open/floor/carpet/orange,/area/shuttle/abandoned/crew)
"by" = (/obj/machinery/atmospherics/pipe/simple/supply,/turf/open/floor/noslip,/area/shuttle/abandoned/engine)
"bz" = (/obj/machinery/atmospherics/pipe/layer_manifold,/turf/open/floor/noslip,/area/shuttle/abandoned/engine)
"bA" = (/obj/machinery/atmospherics/components/unary/vent_scrubber/on/layer3{icon_state = "scrub_map_on-3"; dir = 1},/obj/structure/cable,/turf/open/floor/noslip,/area/shuttle/abandoned/engine)
"bB" = (/obj/machinery/power/apc/auto_name/east,/turf/open/floor/noslip,/area/shuttle/abandoned/engine)
"bC" = (/obj/structure/table,/obj/item/storage/box/donkpockets,/obj/item/storage/box/donkpockets{pixel_x = 5; pixel_y = 12},/turf/open/floor/carpet/orange,/area/shuttle/abandoned/crew)
"bD" = (/obj/structure/table,/obj/machinery/microwave,/turf/open/floor/carpet/orange,/area/shuttle/abandoned/crew)
"bE" = (/obj/structure/bed,/obj/structure/bed{name = "bunk bed"; pixel_y = 10},/turf/open/floor/carpet/orange,/area/shuttle/abandoned/crew)
"bF" = (/obj/machinery/atmospherics/pipe/simple/supply,/obj/machinery/meter,/turf/open/floor/noslip,/area/shuttle/abandoned/engine)
"bG" = (/obj/machinery/atmospherics/pipe/simple/scrubbers,/obj/machinery/meter,/turf/open/floor/noslip,/area/shuttle/abandoned/engine)
"bH" = (/obj/structure/cable,/turf/open/floor/noslip,/area/shuttle/abandoned/engine)
"bI" = (/obj/structure/table,/obj/item/storage/toolbox/emergency,/turf/open/floor/plasteel,/area/shuttle/abandoned/cargo)
"bJ" = (/obj/machinery/atmospherics/components/unary/tank/air{dir = 1},/turf/open/floor/noslip,/area/shuttle/abandoned/engine)
"bK" = (/obj/machinery/atmospherics/components/unary/tank,/turf/open/floor/noslip,/area/shuttle/abandoned/engine)
"bL" = (/obj/machinery/atmospherics/pipe/simple/scrubbers/hidden/layer3{icon_state = "pipe11-3"; dir = 5},/obj/machinery/atmospherics/pipe/simple/supply{icon_state = "pipe11-2"; dir = 5},/turf/open/floor/plasteel,/area/shuttle/abandoned/cargo)
"bM" = (/obj/machinery/atmospherics/pipe/simple/scrubbers/hidden/layer3{icon_state = "pipe11-3"; dir = 4},/obj/machinery/atmospherics/pipe/simple/supply{icon_state = "pipe11-2"; dir = 8},/turf/open/floor/plasteel,/area/shuttle/abandoned/cargo)
"bN" = (/obj/machinery/atmospherics/pipe/simple/supply{icon_state = "pipe11-2"; dir = 9},/obj/machinery/atmospherics/pipe/simple/scrubbers/hidden/layer3{icon_state = "pipe11-3"; dir = 8},/turf/open/floor/plasteel,/area/shuttle/abandoned/cargo)
"bO" = (/obj/machinery/atmospherics/components/unary/vent_scrubber/on/layer3{icon_state = "scrub_map_on-3"; dir = 8},/turf/open/floor/plasteel,/area/shuttle/abandoned/cargo)
"bP" = (/obj/machinery/power/smes,/turf/open/floor/noslip,/area/shuttle/abandoned/engine)
"bQ" = (/obj/machinery/power/port_gen/pacman,/obj/structure/cable,/turf/open/floor/plating,/area/shuttle/abandoned/engine)
"bR" = (/obj/structure/table,/obj/structure/closet/emcloset,/turf/open/floor/plasteel,/area/shuttle/abandoned/cargo)
"bS" = (/obj/machinery/door/airlock/external,/turf/open/floor/plasteel,/area/shuttle/abandoned/cargo)
"bT" = (/obj/structure/chair{dir = 4},/turf/open/floor/plasteel,/area/shuttle/abandoned/cargo)
"bU" = (/obj/machinery/button/door{id = "northwhite"; name = "Loading Hatch"; pixel_y = 26},/turf/open/floor/plasteel,/area/shuttle/abandoned/cargo)
"bV" = (/obj/machinery/atmospherics/pipe/simple/scrubbers/hidden/layer3{icon_state = "pipe11-3"; dir = 4},/obj/machinery/atmospherics/pipe/simple/supply{icon_state = "pipe11-2"; dir = 8},/obj/structure/cable,/obj/machinery/door/airlock/engineering,/turf/open/floor/plasteel,/area/shuttle/abandoned/cargo)
"bW" = (/obj/machinery/door/airlock/hatch{name = "Ship Maintenance"},/turf/open/floor/plating,/area/shuttle/abandoned/cargo)
"bX" = (/obj/structure/table,/turf/open/floor/carpet/royalblue,/area/shuttle/abandoned/bridge)
"bY" = (/obj/structure/closet/crate,/turf/open/floor/plasteel,/area/shuttle/abandoned/cargo)
"bZ" = (/obj/structure/closet/firecloset/full,/turf/open/floor/plasteel,/area/shuttle/abandoned/cargo)
"ca" = (/obj/structure/chair/comfy/shuttle{icon_state = "shuttle_chair"; dir = 1},/turf/open/floor/carpet,/area/shuttle/abandoned/bridge)
"cb" = (/obj/structure/table,/turf/open/floor/plasteel,/area/shuttle/abandoned/cargo)
"cc" = (/obj/structure/closet/crate{icon_state = "crateopen"},/turf/open/floor/plasteel,/area/shuttle/abandoned/cargo)
"cd" = (/obj/machinery/atmospherics/pipe/simple/scrubbers/hidden/layer3,/obj/machinery/atmospherics/pipe/simple/supply,/obj/structure/cable,/obj/machinery/door/airlock/freezer{name = "Medical Bay"},/turf/open/floor/plasteel/white,/area/shuttle/abandoned/medbay)
"ce" = (/obj/machinery/atmospherics/pipe/simple/scrubbers/hidden/layer3{icon_state = "pipe11-3"; dir = 5},/obj/machinery/atmospherics/pipe/simple/supply{icon_state = "pipe11-2"; dir = 6},/obj/structure/chair/comfy/shuttle{dir = 8},/turf/open/floor/carpet,/area/shuttle/abandoned/bridge)
"cf" = (/obj/machinery/atmospherics/pipe/simple/scrubbers/hidden/layer3{icon_state = "pipe11-3"; dir = 4},/obj/machinery/atmospherics/pipe/simple/supply{icon_state = "pipe11-2"; dir = 8},/obj/structure/cable,/obj/machinery/door/airlock/command,/turf/open/floor/carpet/royalblue,/area/shuttle/abandoned/bridge)
"cg" = (/obj/machinery/atmospherics/pipe/simple/scrubbers/hidden/layer3{icon_state = "pipe11-3"; dir = 4},/obj/machinery/atmospherics/pipe/simple/supply{icon_state = "pipe11-2"; dir = 4},/obj/structure/cable,/obj/machinery/door/airlock/public,/turf/open/floor/plasteel,/area/shuttle/abandoned/crew)
"ch" = (/obj/structure/table,/obj/item/stack/cable_coil{pixel_x = 8; pixel_y = 5},/obj/item/stack/cable_coil,/turf/open/floor/plasteel,/area/shuttle/abandoned/cargo)
"ci" = (/obj/machinery/atmospherics/pipe/simple/scrubbers/hidden/layer3,/obj/machinery/atmospherics/pipe/simple/supply,/obj/structure/cable,/obj/machinery/door/airlock/engineering,/turf/open/floor/noslip,/area/shuttle/abandoned/engine)
"cj" = (/obj/structure/chair,/turf/open/floor/noslip,/area/shuttle/abandoned/engine)
"ck" = (/obj/structure/table,/obj/item/storage/toolbox/mechanical,/turf/open/floor/plasteel,/area/shuttle/abandoned/cargo)
"cl" = (/obj/structure/chair/comfy/shuttle,/turf/open/floor/carpet,/area/shuttle/abandoned/bridge)
"cm" = (/obj/machinery/atmospherics/components/unary/vent_pump/on,/obj/structure/closet/crate{icon_state = "crateopen"},/turf/open/floor/plasteel,/area/shuttle/abandoned/cargo)
"cn" = (/obj/machinery/atmospherics/pipe/simple/scrubbers/hidden/layer3{icon_state = "pipe11-3"; dir = 4},/obj/machinery/atmospherics/pipe/simple/supply{icon_state = "pipe11-2"; dir = 8},/obj/machinery/door/airlock/engineering,/turf/open/floor/plasteel,/area/shuttle/abandoned/cargo)
"co" = (/obj/machinery/suit_storage_unit,/turf/open/floor/plasteel,/area/shuttle/abandoned/cargo)
"cp" = (/obj/structure/tank_dispenser/oxygen,/turf/open/floor/plasteel,/area/shuttle/abandoned/cargo)
"cq" = (/obj/machinery/button/door{id = "southwhite"; name = "Loading Hatch"; pixel_y = -6},/turf/open/floor/plasteel,/area/shuttle/abandoned/cargo)
"cr" = (/obj/machinery/door/poddoor{id = "southwhite"},/turf/open/floor/plating,/area/shuttle/abandoned/cargo)

(1,1,1) = {"
aaaaaaaaaaaaaaaaaaaaaaaaaaaaaaabafabaaaaaaaaaaaaaaaaaaaaaa
aaaaaaaaaaaaacacacacacabababababajababababbdbdbdababaaaaaa
aaaaaaaaacacacagahaiacbibpbIbRabbSabakabbTadadadbUabababab
alalalalacamanaoapaqacadarasasasasasasbVasatauavavbWaeawax
aybXbXbXacaAanaBaCanacadaDaEaEaEaEaEaEaEbYaFadavbZabaeawax
aybXcabXacaHaIaJaKanacadaDaEaLaMaNaOaPaEcbcbadavadabaeawax
ayazaGazacaQanaRaSaTacadaDaEaUaMaVaOaUaEcbadadavccabaeawax
ayaWaXaYacacaccdacacacaZaDaEaUbabbaUaUaEcbadbYavadabaeawax
aybccebecfasasbfbgbgbgbhbfcgbjbkbbaUaUaEchadadavblabaeawax
aybmbnazbobobociboboboadbqaEaUbraUaUaUaEcbadadbYbYabaeawax
ayazaGazbobsbtbubvcjboadbqaEbxaUaUaUaUaEckadadadadabaeawax
aybXclbXbobybzbAbwbBboadbqaEbxbCbDbEbEaEcbcbadadadabaeawax
aybXbXbXbobFbGbHbwbwboadbqaEaEaEaEaEaEaEadcmadadccabaeawax
alalalalbobJbKbHbwbwboadbLbMbMbMbMbMbMcnbMbNbOadadbWaeawax
aaaaaaaabobobobPbHbQbococococpabbSabakabbTadadadcqabababab
aaaaaaaaaaaaboboboboboabababababajababababcrcrcrababaaaaaa
aaaaaaaaaaaaaaaaaaaaaaaaaaaaaaabafabaaaaaaaaaaaaaaaaaaaaaa
aaaaaaaaaaaaaaaaaaaaaaaaaaaaaaaaaaaaaaaaaaaaaaaaaaaaaaaaaa
"}
